W,W,W,W,W,W,E,E,W,W,W,W,W,W
W,W,W,W,F,F,F,F,H,H,H,D,H,W
W,W,W,W,F,F,F,F,H,H,F,F,H,W
W,W,W,W,F,F,F,F,F,F,F,H,H,W
W,W,W,W,F,F,F,F,F,H,H,H,H,W
W,W,W,W,F,F,F,F,F,H,H,H,H,W
W,W,W,W,F,F,F,F,W,W,W,W,W,W
E,F,F,F,F,F,F,F,W,F,F,F,D,W
E,F,F,F,F,F,F,F,W,W,W,W,W,W
W,W,W,W,W,W,W,W,W,W,W,W,W,W