W,H,H,H,H,H,H,H,H,H,H,H,H,H
W,H,F,F,F,F,H,H,H,F,F,H,H,H
W,H,H,F,F,F,F,H,H,F,F,H,H,H
W,H,H,H,H,H,H,H,H,H,F,H,H,H
E,F,F,F,F,F,F,F,H,H,H,H,H,H
E,F,F,F,F,F,F,F,H,H,H,H,H,H
W,W,W,W,W,W,F,F,H,H,H,H,H,H
W,W,W,W,W,W,F,F,H,H,H,H,H,H
W,W,W,W,W,W,F,F,F,H,H,H,H,H
W,W,W,W,W,W,E,E,H,H,H,H,H,H