H,H,H,H,H,H,H,H,H,H,W,W,W,W
H,H,H,H,H,H,H,H,H,H,W,W,W,W
H,H,H,H,H,H,H,H,H,H,W,F,F,W
H,H,H,H,H,H,H,H,H,H,W,F,F,W
H,H,H,H,H,H,H,H,H,H,W,W,F,E
H,H,H,H,H,H,H,H,H,H,W,F,F,E
H,F,F,F,H,H,W,W,W,W,W,F,F,W
H,F,F,F,H,H,F,F,F,F,F,F,F,W
H,F,F,F,H,H,F,F,F,F,F,F,F,W
H,H,H,H,H,H,E,E,W,W,W,W,W,W