W,W,W,W,W,W,E,E,W,W,W,W,W,W
W,W,W,F,W,W,F,F,W,W,W,W,W,W
W,W,F,F,F,W,F,F,W,W,W,W,W,W
W,W,W,W,W,W,F,F,W,W,W,W,W,W
W,W,W,W,W,W,F,F,W,W,W,W,W,W
W,F,F,F,F,F,F,F,F,F,F,F,F,W
W,F,F,F,F,F,F,F,F,F,F,F,F,W
W,F,F,F,F,F,F,F,F,F,F,F,F,W
W,D,F,F,F,F,F,F,F,F,F,F,D,W
W,W,W,W,W,W,E,E,W,W,W,W,W,W