W,W,W,W,W,W,E,E,W,W,W,W,W,W
W,H,H,H,H,W,F,F,W,H,H,W,W,W
W,H,H,H,H,W,F,F,W,H,H,W,W,W
W,F,F,D,F,F,F,F,F,F,D,W,W,W
W,W,W,W,W,W,W,W,W,W,W,W,W,W
W,F,F,F,W,W,W,W,W,W,F,F,F,W
W,F,F,F,W,W,W,W,W,W,F,F,F,W
W,F,F,F,F,F,F,F,F,F,F,F,F,E
W,F,F,F,F,F,F,F,F,F,F,F,F,E
W,W,W,W,W,W,W,W,W,W,W,W,W,W