W,W,W,W,W,W,W,W,W,W,W,W,W,W
W,F,F,F,F,F,W,W,F,F,F,F,F,W
W,F,F,F,F,F,W,W,F,F,F,F,F,W
W,F,F,F,F,F,W,W,F,F,F,F,F,W
E,F,F,F,F,F,F,F,F,F,F,F,F,W
E,F,F,F,F,F,F,F,F,F,F,F,F,W
W,F,F,F,F,F,W,W,F,F,F,F,F,W
W,F,F,F,F,F,W,W,F,F,F,F,F,E
W,F,F,F,F,F,W,W,F,F,F,F,F,E
W,W,W,W,W,W,W,W,W,W,W,W,W,W