H,W,W,W,W,W,W,W,W,W,W,W,H,H,H,H
H,W,W,F,F,F,F,F,F,F,F,F,H,H,H,H
H,W,W,F,F,F,W,F,F,F,F,F,F,H,H,H
H,W,W,DC,F,F,F,F,F,F,F,F,F,F,W,H
H,W,W,W,W,W,W,W,W,H,H,W,W,W,W,H
H,W,F,F,F,F,F,F,F,F,F,F,F,F,W,H
H,F,F,F,F,F,F,F,F,F,F,F,F,G,F,H
H,F,F,F,F,F,F,F,F,F,F,F,F,G,F,H
H,F,F,F,F,W,W,W,W,W,W,DC,F,G,F,H
H,W,W,W,W,W,W,W,W,W,W,W,W,W,W,H