H,H,W,W,W,W,W,W,W,W,W,W,W,W,W,H
H,H,F,F,F,F,F,F,F,F,F,F,F,F,F,H
H,H,F,F,F,F,F,F,F,F,F,F,F,F,F,H
H,H,F,F,F,F,W,W,W,C,W,W,W,W,F,H
H,H,F,F,F,F,W,W,W,F,F,F,F,F,H,H
H,H,H,C,H,H,H,H,H,F,F,F,F,F,H,H
H,H,H,H,H,H,H,H,H,F,H,H,H,H,H,H
H,H,H,H,H,H,H,H,H,F,F,F,F,H,H,H
H,H,H,H,H,H,H,H,H,H,H,H,F,H,H,H
H,H,H,H,H,H,H,H,H,F,F,F,F,H,H,H
H,F,F,F,F,F,F,F,F,F,F,H,H,H,H,H
H,F,F,F,F,F,F,F,F,F,F,H,H,H,H,H
H,F,F,F,F,F,F,F,F,F,H,H,H,H,H,H
H,W,W,W,W,W,W,W,W,W,H,H,H,H,H,H