H,W,W,W,W,W,W,W,W,W,W,W,W,W,W,H
H,W,F,F,F,F,F,H,H,F,F,F,F,F,W,H
H,W,F,F,F,F,F,H,H,F,F,F,F,F,W,H
H,W,F,F,F,F,F,W,W,F,F,F,F,F,W,H
H,W,F,F,F,F,F,F,F,F,F,F,F,F,F,H
H,W,F,F,F,F,F,F,F,F,F,C,F,F,F,H
H,W,F,F,F,F,F,W,W,F,F,F,F,F,W,H
H,W,F,F,F,F,F,H,H,F,F,F,F,F,W,H
H,W,F,F,F,F,F,H,H,F,F,F,F,F,W,H
H,W,W,W,W,W,W,W,W,W,W,W,W,W,W,H