H,W,W,W,W,W,W,W,W,W,W,W,W,W,W,H
H,W,W,H,H,H,H,F,F,H,H,H,H,W,W,H
H,W,F,F,F,F,F,F,F,F,F,F,F,F,W,H
H,F,F,F,F,F,F,F,F,F,F,F,F,F,F,H
H,F,F,F,F,F,F,F,F,F,F,F,F,F,F,H
H,F,F,F,F,F,F,F,F,F,F,F,F,F,F,H
H,H,H,H,H,H,H,H,H,H,H,C,H,H,H,H
H,H,H,H,H,H,H,H,H,H,H,H,H,H,H,H
H,H,H,H,H,H,H,H,H,H,H,H,H,H,H,H
H,H,H,H,H,H,H,H,H,H,H,H,H,H,H,H