W,W,W,W,W,W,W,W,W,W,W,W,W,W
W,W,W,F,F,F,F,F,F,F,F,W,W,W
W,W,F,F,F,F,F,F,F,F,F,F,W,W
W,F,F,F,F,F,F,F,F,F,F,F,F,W
E,F,F,F,F,F,F,F,F,F,F,F,F,E
E,F,F,F,F,F,F,F,F,F,F,F,F,E
H,H,H,H,C,H,H,H,H,H,H,H,H,H
H,H,H,H,H,H,H,H,H,H,H,H,H,H
H,H,H,H,H,H,H,H,H,H,H,H,H,H
H,H,H,H,H,H,H,H,H,H,H,H,H,H