W,W,W,W,W,W,W,W,W,W,W,W,W,W
W,F,F,F,F,H,H,H,F,F,F,F,F,W
W,F,F,F,F,H,H,H,F,F,F,F,F,W
W,F,F,F,F,H,H,H,F,F,F,F,F,W
E,F,F,W,W,W,W,W,F,F,F,F,F,E
E,F,F,F,F,W,W,W,F,F,F,F,F,E
W,F,F,F,F,W,W,W,H,H,F,F,F,W
W,F,F,F,F,F,F,F,F,F,F,F,F,W
W,F,F,F,F,F,F,F,F,F,F,F,F,W
W,W,W,W,W,W,W,W,W,W,W,W,W,W