W,W,W,W,W,W,E,E,W,W,W,W,W,W
W,W,F,F,C,F,H,F,F,F,F,F,F,W
W,W,F,F,F,F,H,F,F,F,F,F,F,W
W,W,W,W,F,F,W,F,F,W,H,H,H,W
E,F,F,W,H,H,W,F,F,W,F,F,F,E
E,F,F,W,H,H,W,F,F,W,F,F,F,E
W,F,F,W,H,H,W,F,F,W,F,F,F,W
W,F,F,F,F,F,F,F,F,F,F,F,F,W
W,F,F,F,F,F,F,F,C,F,F,F,F,W
W,W,W,W,W,W,W,W,W,W,W,W,W,W