W,W,W,W,W,H,H,H,H,H,H,H,H,H
W,F,F,F,F,F,F,W,F,F,F,F,F,H
W,F,F,F,F,F,F,F,F,F,F,F,F,H
W,F,F,W,W,F,H,H,H,H,H,H,H,H
E,F,F,W,W,F,H,H,H,H,F,F,F,E
E,F,F,W,W,F,H,F,F,H,F,F,F,E
W,F,F,F,F,F,F,F,F,H,F,H,H,H
W,F,F,F,F,F,F,F,F,F,F,H,H,H
W,W,W,W,W,W,W,W,W,H,H,H,H,H
W,W,W,W,W,W,W,W,W,H,H,H,H,H