W,W,W,W,W,W,W,W,W,W,W,W,W,W
W,F,F,F,F,F,F,F,F,F,F,F,F,W
W,F,W,W,W,F,F,F,F,W,W,W,F,W
W,F,W,F,F,F,F,F,F,F,F,W,F,W
W,F,W,F,F,F,F,F,F,F,F,W,F,W
W,F,F,F,F,F,F,F,F,F,F,F,F,W
W,F,F,F,F,F,F,F,F,F,F,F,F,W
E,F,F,F,F,F,F,F,F,F,F,F,F,E
E,F,F,F,F,F,F,F,F,F,F,F,F,E
W,W,W,W,W,W,W,W,W,W,W,W,W,W