H,H,H,H,H,W,W,W,W,W,W,W,W,W
H,H,H,H,F,F,F,F,F,F,F,F,F,W
H,H,F,F,F,F,F,F,F,F,F,F,F,W
H,H,F,F,F,F,F,F,F,W,F,F,D,W
H,F,F,F,F,F,F,F,F,F,F,F,F,W
W,W,W,W,H,H,W,W,W,W,W,W,W,W
W,W,F,F,F,F,F,F,F,F,F,F,W,W
E,F,F,F,F,F,F,F,F,F,F,F,W,W
E,F,F,D,W,W,F,F,W,W,F,F,W,W
W,W,W,W,W,W,E,E,W,W,W,W,W,W