W,W,W,W,W,W,E,E,W,W,W,W,W,W
W,F,F,F,F,F,F,F,F,F,F,F,F,W
W,F,F,F,F,F,F,C,F,F,F,F,F,W
W,F,F,F,F,F,F,F,F,F,F,F,F,W
W,H,H,H,H,W,F,F,W,H,H,H,H,W
W,H,H,H,H,W,F,F,W,H,H,H,H,W
W,F,F,F,F,F,F,F,F,F,F,F,F,W
W,F,F,F,F,F,F,F,F,F,F,F,F,W
W,F,F,F,F,F,F,F,F,F,F,F,F,W
W,W,W,W,W,W,E,E,W,W,W,W,W,W