W,W,W,W,W,W,E,E,W,W,W,W,W,W
W,F,F,F,F,F,F,F,F,D,F,W,W,W
W,F,F,F,F,F,F,F,F,W,F,F,F,W
W,F,F,W,W,W,W,W,W,W,H,H,H,W
W,F,F,C,F,F,F,F,F,F,F,F,F,W
W,F,F,F,F,F,F,F,F,D,F,F,F,W
W,H,H,H,W,W,W,W,W,W,W,F,F,W
W,F,F,F,F,F,F,F,F,F,F,F,F,W
W,F,F,F,F,F,F,F,F,F,F,F,F,W
W,W,W,W,W,W,W,W,W,W,W,W,W,W