W,W,W,W,W,W,E,E,W,W,W,W,W,W
W,F,F,F,F,F,F,F,W,F,F,C,F,W
W,F,F,F,F,F,F,F,W,F,F,F,F,W
W,F,F,F,F,W,W,W,W,F,F,F,F,W
W,F,F,H,H,F,F,F,W,W,F,W,W,W
W,F,F,H,H,F,F,F,H,H,F,F,F,W
W,F,F,F,F,W,F,F,H,H,H,H,H,W
W,F,W,F,F,F,F,F,H,H,H,H,H,W
W,C,W,F,F,F,F,F,H,H,H,H,H,W
W,W,W,W,W,W,E,E,W,W,W,W,W,W