W,W,W,W,W,W,W,W,W,W,W,W,W,W
W,F,W,F,F,F,F,F,F,F,F,W,I,W
W,W,W,F,F,F,F,F,F,F,F,W,W,W
W,F,F,F,F,F,F,F,F,F,F,F,F,W
E,F,F,F,F,F,F,F,F,F,F,F,F,E
E,F,F,F,F,F,F,F,F,F,F,F,F,E
W,F,F,F,F,F,F,F,F,F,F,F,F,W
W,W,W,F,F,F,F,F,F,F,F,W,W,W
W,F,W,F,F,F,F,F,F,F,F,W,I,W
W,W,W,W,W,W,E,E,W,W,W,W,W,W