H,W,W,W,W,W,W,W,W,W,W,W,W,W,W,H
H,W,F,I,I,I,I,H,H,F,F,F,F,F,W,H
H,W,I,I,I,I,F,H,H,F,F,F,F,F,W,H
H,W,I,I,I,I,F,W,W,F,F,F,F,F,W,H
H,W,F,F,F,F,I,I,I,W,F,F,F,F,F,H
H,W,F,F,F,F,I,I,I,F,F,C,F,F,F,H
H,W,F,F,F,F,F,W,W,F,F,F,F,F,W,H
H,W,F,F,F,F,F,H,H,F,F,F,F,F,W,H
H,W,F,F,F,F,F,H,H,F,F,F,F,F,W,H
H,W,W,W,W,W,W,W,W,W,W,W,W,W,W,H