H,H,H,H,H,H,W,W,H,H,H,H,H,H
H,H,H,H,H,H,F,F,H,H,H,H,H,H
H,H,H,H,H,H,I,I,F,F,F,H,H,W
H,H,H,H,H,H,I,I,F,F,F,H,H,W
H,H,H,H,H,H,I,I,F,F,F,F,F,E
H,H,H,H,H,H,I,I,F,F,F,F,F,E
H,H,H,H,H,H,I,I,F,F,F,F,F,W
H,H,H,H,H,H,F,F,F,F,F,F,F,W
H,H,H,H,H,H,F,F,F,F,F,F,F,W
H,H,H,H,H,H,E,E,W,W,W,W,W,W