W,W,W,W,W,W,W,W,W,W,W,W,W,W
W,H,H,H,H,H,I,I,H,H,H,H,H,W
W,H,H,H,H,H,I,I,F,F,F,H,H,W
W,H,H,H,H,H,I,I,F,F,F,H,H,W
W,H,H,H,H,H,I,I,H,F,F,F,F,E
W,H,H,H,H,H,I,I,H,F,F,F,F,E
W,H,H,H,H,H,I,I,H,H,H,H,H,W
W,H,H,H,H,H,F,F,H,H,H,H,H,W
W,H,H,H,H,H,F,F,H,H,H,H,H,W
W,W,W,W,W,W,E,E,W,W,W,W,W,W