W,W,W,W,W,W,W,W,W,W,W,W,W,W
W,I,I,I,I,W,W,W,W,W,W,W,W,W
W,I,I,I,I,W,H,H,H,H,W,W,W,W
W,I,I,I,I,W,I,I,I,I,F,F,F,W
E,F,F,W,I,I,I,I,I,I,F,F,F,W
E,F,F,W,I,W,H,H,H,H,W,F,F,W
W,I,I,W,W,W,W,W,W,W,W,F,F,W
W,I,I,I,I,W,F,F,F,F,F,F,F,W
W,I,I,I,I,W,F,F,F,F,F,F,F,W
W,W,W,W,W,W,E,E,W,W,W,W,W,W