W,W,W,W,W,W,E,E,W,W,W,W,W,W
W,I,I,I,I,I,F,F,I,I,I,I,I,W
W,I,I,I,I,I,F,F,I,I,I,I,I,W
W,I,I,F,F,F,F,F,F,F,F,I,I,W
W,I,I,F,F,F,F,F,F,F,F,I,I,W
W,I,I,F,F,F,F,F,F,F,F,I,I,W
W,I,I,F,F,F,F,F,F,F,F,I,I,W
W,I,I,I,I,I,F,F,I,I,I,I,I,W
W,I,I,I,I,I,F,F,I,I,I,I,I,W
W,W,W,W,W,W,E,E,W,W,W,W,W,W