W,W,W,W,W,W,E,E,W,W,W,W,W,W
W,I,I,I,I,I,F,F,F,W,W,F,F,W
W,I,I,I,I,I,F,F,F,W,W,I,I,W
W,I,I,W,W,W,W,W,W,W,W,I,I,W
W,I,I,W,W,W,W,W,W,W,W,I,I,W
W,I,I,W,W,W,W,W,W,W,W,I,I,W
W,I,I,W,W,W,W,W,W,W,W,I,I,W
W,I,I,I,I,I,I,I,I,F,F,F,F,W
W,I,I,I,I,I,I,I,I,F,F,F,F,W
W,W,W,W,W,W,W,W,W,W,W,E,E,W