W,W,W,W,W,W,E,E,W,W,W,W,W,W
W,I,I,I,I,I,F,F,F,H,H,F,F,W
W,I,I,I,I,I,F,F,DC,W,W,I,I,W
W,I,I,W,W,W,W,W,W,W,W,I,I,W
W,I,I,W,W,W,W,W,W,W,W,I,I,W
W,I,I,W,W,W,W,W,W,W,W,I,I,W
W,I,I,W,W,W,W,W,W,W,W,I,I,W
W,I,I,I,I,I,I,I,I,F,F,F,F,W
W,I,I,I,I,I,I,I,DC,F,F,F,F,W
W,W,W,W,W,W,W,W,W,W,W,E,E,W