W,W,W,W,W,W,E,E,W,W,W,W,W,W
W,F,F,F,F,F,F,F,W,I,I,W,W,W
W,F,F,F,F,F,F,F,W,I,I,I,I,W
W,F,F,F,F,F,F,F,W,I,I,I,I,W
E,F,F,F,F,F,F,F,W,I,I,I,I,W
E,F,F,F,F,F,F,F,W,I,I,I,I,W
W,F,F,W,W,W,W,W,W,I,I,I,I,W
W,I,I,I,I,I,I,I,I,I,I,I,I,W
W,I,I,I,I,I,I,I,I,I,I,I,I,W
W,W,W,W,W,W,E,E,W,W,W,W,W,W