W,W,W,W,W,W,W,W,W,W,W,E,E,W
E,F,F,F,F,H,H,H,H,H,H,F,F,W
E,F,F,F,F,H,H,H,H,H,H,F,F,W
W,W,W,I,I,H,H,H,H,H,H,F,F,W
H,H,H,I,I,I,I,I,I,H,H,F,F,W
H,H,H,I,I,I,I,I,I,H,H,F,F,W
H,H,H,I,I,H,H,H,H,H,H,F,F,W
W,W,W,I,I,I,I,I,I,I,I,F,F,W
W,W,W,W,I,I,I,I,I,I,I,F,F,W
W,W,W,W,W,W,W,W,W,W,W,W,W,W