W,W,W,W,W,W,E,E,W,W,W,W,W,W
W,I,I,I,I,I,F,F,F,F,F,F,F,E
W,I,I,I,I,I,F,F,F,F,F,F,F,E
W,I,H,H,H,W,W,W,W,F,F,H,H,W
W,I,I,I,H,F,F,F,F,F,F,H,H,W
W,I,I,I,H,F,F,F,F,F,F,H,H,W
W,I,I,I,H,H,H,H,H,H,H,H,H,W
H,H,I,I,I,I,I,I,H,I,I,I,I,W
H,H,I,I,I,I,I,I,I,I,I,I,I,W
W,W,W,W,W,W,W,W,W,W,W,H,H,W